1111111111
100001Z001
10C0000001
1000CE0001
1100000011
10P000Z001
1111111111
