11111111    0
1000CEP1    0
10000001    0
11111111    0