1111111111111111111111111111111111
1E0000000Z00000C00000C0000Z0000001
1010010100100000101001000000010101
1010010010101010001001000000010101
1C00Z0000C00C000Z00000000P000000C1
1111111111111111111111111111111111