11111
1CE11
1E111
11111
11P11
11111

