111111
100101
1E0P01
10PP01
100001
111111
111111
