11111
10001
1EC01
11001
11111
