1111111111111111
10C011000010P011
1111110111111111
1111CCCC11011011
1111111111111111
