11111
1C01
1E11
1111
11P1
1111

