1111
1CP1
1E11
1111
1111
1111

