11111
10001
1EC01
11P01
11111
