1111111111111111
10CE11000010P011
1111110111111111
1111CCCC11P11E11
1111111111111111
