1111111111111111
1000001000010001
1111110111111111
1111110111111111
1111111111111111
