111111
100101
1E0P01
100P01
100001
111111
111111
